9

0 0
5 11
0 0  0 0  0 0  0 0  0 0  0 0  0 0  0 0  0 0  0 0  0 0
0 0  0 0  0 0  0 0  0 0  0 0  0 0  0 0  0 0  0 0  0 0
0 0  0 0  0 0  0 0  1 2  0 0  0 0  0 0  0 0  0 0  0 0
0 0  0 0  0 0  0 0  1 2  0 0  0 0  4 0  0 0  4 0  0 0
3 0  1 0  1 0  1 0  1 0  1 0  1 2  1 2  3 4  1 2  1 2

1 0
6 7
0 0  0 0  0 0  0 0  0 0  0 0  0 0
0 0  0 0  0 0  0 0  0 0  0 0  0 0
0 0  1 1  1 1  1 1  1 1  1 1  0 0
0 0  0 0  0 0  0 0  0 0  0 0  0 0
0 0  0 0  4 0  0 0  4 0  0 0  0 0
3 3  1 1  1 2  3 2  1 2  1 1  3 4

1 1
6 7
0 0  0 0  0 0  0 0  0 0  0 0  0 0
4 0  0 0  0 0  0 0  0 0  0 0  0 0
1 1  0 0  1 2  3 1  1 2  0 0  0 0
0 0  0 0  0 0  0 0  0 0  0 0  0 0
0 0  0 0  4 0  0 0  4 0  0 0  0 0
3 6  1 1  1 1  3 2  1 1  1 1  3 -6

1 2
15 5
0 0  0 0  0 0  0 0  0 0
0 0  0 0  0 0  0 0  0 0
0 0  0 0  3 1  0 0  0 0
0 0  0 0  0 0  0 0  0 0
0 0  0 0  0 0  0 0  0 0
1 2  0 0  0 0  0 0  0 0
0 0  0 0  0 0  0 0  0 0
0 0  0 0  0 0  0 0  0 0
0 0  0 0  0 0  1 2  0 0
0 0  0 0  0 0  0 0  0 0
0 0  0 0  0 0  0 0  0 0
0 0  1 2  0 0  0 0  0 0
0 0  0 0  0 0  0 0  0 0
4 0  4 0  4 0  4 0  4 0
1 0  1 0  1 0  1 0  1 0

2 0
6 6
0 0  0 0  0 0  0 0  0 0  0 0
0 0  0 0  0 0  0 0  0 0  4 0
0 0  0 0  0 0  0 0  3 4  1 0
0 0  0 0  0 0  0 0  0 0  0 0
0 0  0 0  0 0  0 0  0 0  4 0
3 3  1 0  1 0  1 0  1 0  1 0

3 0
10 10
0 0  0 0  0 0  0 0  0 0  0 0  0 0  0 0  0 0  0 0
0 0  0 0  0 0  0 0  0 0  0 0  0 0  0 0  0 0  0 0
0 0  0 0  0 0  0 0  0 0  0 0  0 0  0 0  1 2  0 0
0 0  0 0  0 0  0 0  0 0  0 0  0 0  0 0  1 1  3 4
0 0  0 0  0 0  0 0  0 0  0 0  0 0  0 0  0 0  0 0
0 0  0 0  0 0  0 0  0 0  0 0  1 2  4 0  0 0  0 0
0 0  0 0  0 0  0 0  0 0  0 0  1 1  1 1  1 1  1 1
0 0  0 0  0 0  0 0  0 0  0 0  0 0  0 0  0 0  0 0
0 0  0 0  0 0  0 0  1 2  4 0  0 0  0 0  0 0  0 0
3 3  1 1  1 1  1 1  1 1  1 1  1 1  1 1  1 1  1 1

4 0
6 7
0 0  0 0  0 0  0 0  0 0  0 0 0 0
0 0  4 0  0 0  0 0  0 0  4 0 0 0
1 1  1 1  0 0  3 2  0 0  1 1 1 1
0 0  0 0  0 0  0 0  0 0  0 0 0 0
4 0  0 0  0 0  0 0  0 0  0 0 4 0
1 1  1 1  1 1  3 3  1 1  1 1 1 1

4 1
10 7
0 0  0 0  0 0  0 0  0 0  0 0 0 0
0 0  0 0  0 0  0 0  0 0  0 0 4 0
4 0  0 0  4 0  0 0  0 0  1 2 3 4
1 2  0 0  1 2  1 2  1 2  1 2 1 2
0 0  0 0  0 0  0 0  0 0  0 0 0 0
0 0  0 0  0 0  0 0  4 0  0 0 0 0
1 1  1 1  1 1  1 1  1 1  0 0 0 0
0 0  0 0  0 0  0 0  0 0  0 0 0 0
0 0  0 0  0 0  0 0  4 0  0 0 0 0
3 1  1 0  1 0  1 0  1 0  1 0 1 0

5 1
9 10
0 0  0 0  0 0  0 0  0 0  0 0 0 0  0 0  0 0 0 0
4 0  4 0  0 0  0 0  0 0  0 0 0 0  0 0  0 0 0 0
1 1  1 1  0 0  0 0  0 0  0 0 0 0  0 0  0 0 0 0
0 0  0 0  0 0  0 0  0 0  0 0 0 0  0 0  0 0 4 0
4 0  4 0  0 0  0 0  0 0  0 0 0 0  0 0  4 0 1 2
1 1  1 1  1 1  1 1  0 0  0 0 0 0  4 0  1 2 1 2
0 0  0 0  0 0  0 0  0 0  0 0 4 0  1 2  1 2 1 2
0 0  0 0  0 0  0 0  0 0  4 0 1 2  1 2  1 2 1 2
3 3  1 0  1 0  1 0  1 0  1 0 1 0  1 0  1 0 1 0
